Season,Team,Player Name,Accumulated Playing Time,Accumulated Goals Scored,Accumulated Goals Lost,Plus-Minus,Plus-Minus Per Min
2016-2017,Everton,Joel Robles,1736,40,20,20,0.01152073732718894
2016-2017,Everton,Morgan Schneiderlin,1059,25,13,12,0.0113314447592068
2016-2017,Everton,Leighton Baines,2821,51,33,18,0.006380716058135413
2016-2017,Everton,Ashley Williams,3240,52,41,11,0.0033950617283950617
2016-2017,Everton,Phil Jagielka,2333,33,33,0,0.0
2016-2017,Everton,Ross Barkley,2999,51,38,13,0.004334778259419807
2016-2017,Everton,Romelu Lukaku,3357,58,43,15,0.004468275245755138
2016-2017,Everton,Kevin Mirallas,2142,40,26,14,0.006535947712418301
2016-2017,Everton,Idrissa Gana Gueye,2769,41,31,10,0.0036114120621162874
2016-2017,Everton,Tom Davies,1542,27,17,10,0.00648508430609598
2016-2017,Everton,Mason Holgate,1362,20,17,3,0.0022026431718061676
2016-2017,Everton,Gareth Barry,2183,32,29,3,0.001374255611543747
2016-2017,Everton,Enner Valencia,888,16,11,5,0.00563063063063063
2016-2017,West Bromwich Albion,Ben Foster,3600,44,56,-12,-0.0033333333333333335
2016-2017,West Bromwich Albion,Allan Nyom,2818,37,45,-8,-0.0028388928317956
2016-2017,West Bromwich Albion,Jonny Evans,2728,29,43,-14,-0.005131964809384164
2016-2017,West Bromwich Albion,Jake Livermore,3112,28,60,-32,-0.010282776349614395
2016-2017,West Bromwich Albion,Salomón Rondón,3076,38,49,-11,-0.003576072821846554
2016-2017,West Bromwich Albion,Chris Brunt,2611,34,40,-6,-0.002297970126388357
2016-2017,West Bromwich Albion,James McClean,1597,14,30,-16,-0.010018785222291797
2016-2017,West Bromwich Albion,Gareth McAuley,3323,42,50,-8,-0.0024074631357207344
2016-2017,West Bromwich Albion,Darren Fletcher,3376,44,48,-4,-0.001184834123222749
2016-2017,West Bromwich Albion,Craig Dawson,3458,41,55,-14,-0.004048582995951417
2016-2017,West Bromwich Albion,Hal Robson-Kanu,649,11,10,1,0.0015408320493066256
2016-2017,West Bromwich Albion,Claudio Yacob,2462,33,37,-4,-0.0016246953696181965
2016-2017,West Bromwich Albion,James Morrison,1812,29,23,6,0.0033112582781456954
2016-2017,West Bromwich Albion,Nacer Chadli,2326,28,36,-8,-0.0034393809114359416
2016-2017,Middlesbrough,Brad Guzan,900,7,17,-10,-0.011111111111111112
2016-2017,Middlesbrough,Fábio,1841,11,28,-17,-0.009234111895708854
2016-2017,Middlesbrough,George Friend,2047,18,35,-17,-0.008304836345872008
2016-2017,Middlesbrough,Ben Gibson,3510,28,53,-25,-0.007122507122507123
2016-2017,Middlesbrough,Adam Clayton,2890,26,45,-19,-0.00657439446366782
2016-2017,Middlesbrough,Álvaro Negredo,2966,26,45,-19,-0.0064059339177343225
2016-2017,Middlesbrough,Marten de Roon,2778,21,44,-23,-0.00827933765298776
2016-2017,Middlesbrough,Stewart Downing,2284,20,39,-19,-0.008318739054290718
2016-2017,Middlesbrough,Calum Chambers,2340,22,37,-15,-0.00641025641025641
2016-2017,Middlesbrough,Adam Forshaw,2782,21,36,-15,-0.005391804457225018
2016-2017,Middlesbrough,Bernardo Espinosa,975,4,13,-9,-0.009230769230769232
2016-2017,Middlesbrough,Grant Leadbitter,732,3,12,-9,-0.012295081967213115
2016-2017,Middlesbrough,Antonio Barragán,2286,22,32,-10,-0.004374453193350831
2016-2017,Middlesbrough,Cristhian Stuani,1341,9,15,-6,-0.0044742729306487695
2016-2017,Middlesbrough,Adama Traoré,1602,15,22,-7,-0.004369538077403246
2016-2017,Bournemouth,Artur Boruc,3240,50,61,-11,-0.0033950617283950617
2016-2017,Bournemouth,Simon Francis,3039,45,54,-9,-0.0029615004935834156
2016-2017,Bournemouth,Steve Cook,3510,53,65,-12,-0.003418803418803419
2016-2017,Bournemouth,Marc Pugh,1306,20,22,-2,-0.0015313935681470138
2016-2017,Bournemouth,Harry Arter,3045,48,60,-12,-0.003940886699507389
2016-2017,Bournemouth,Charlie Daniels,3150,45,51,-6,-0.0019047619047619048
2016-2017,Bournemouth,Adam Smith,3189,44,59,-15,-0.004703668861712135
2016-2017,Bournemouth,Joshua King,2820,37,52,-15,-0.005319148936170213
2016-2017,Bournemouth,Junior Stanislas,1467,24,27,-3,-0.002044989775051125
2016-2017,Bournemouth,Dan Gosling,1360,18,23,-5,-0.003676470588235294
2016-2017,Bournemouth,Ryan Fraser,1788,31,30,1,0.0005592841163310962
2016-2017,Bournemouth,Tyrone Mings,505,8,14,-6,-0.011881188118811881
2016-2017,Bournemouth,Jordon Ibe,1113,17,23,-6,-0.005390835579514825
2016-2017,Sunderland,Jordan Pickford,2700,19,54,-35,-0.012962962962962963
2016-2017,Sunderland,Billy Jones,2357,18,51,-33,-0.014000848536274925
2016-2017,Sunderland,Jason Denayer,1880,15,29,-14,-0.007446808510638298
2016-2017,Sunderland,Seb Larsson,1515,11,35,-24,-0.015841584158415842
2016-2017,Sunderland,Fabio Borini,1739,10,32,-22,-0.012650948821161587
2016-2017,Sunderland,John O'Shea,2186,15,42,-27,-0.012351326623970723
2016-2017,Sunderland,Didier Ibrahim Ndong,2609,23,51,-28,-0.010732081257186662
2016-2017,Sunderland,Jermain Defoe,3413,28,66,-38,-0.011133899794901847
2016-2017,Sunderland,Javier Manquillo,1417,9,28,-19,-0.013408609738884969
2016-2017,Sunderland,Lamine Koné,2634,21,48,-27,-0.010250569476082005
2016-2017,Sunderland,Victor Anichebe,1204,12,20,-8,-0.006644518272425249
2016-2017,Sunderland,Vito Mannone,810,10,17,-7,-0.008641975308641974
2016-2017,Sunderland,Bryan Oviedo,1416,11,27,-16,-0.011299435028248588
2016-2017,Sunderland,Papy Djilobodji,1626,18,38,-20,-0.012300123001230012
2016-2017,Sunderland,Jack Rodwell,1577,13,35,-22,-0.013950538998097653
2016-2017,Sunderland,Wahbi Khazri,896,7,21,-14,-0.015625
2016-2017,Sunderland,Darron Gibson,627,2,10,-8,-0.012759170653907496
2016-2017,Stoke City,Erik Pieters,3150,35,46,-11,-0.003492063492063492
2016-2017,Stoke City,Joe Allen,2936,29,44,-15,-0.005108991825613079
2016-2017,Stoke City,Glenn Whelan,2269,24,35,-11,-0.004847950639048039
2016-2017,Stoke City,Glen Johnson,1955,25,32,-7,-0.0035805626598465474
2016-2017,Stoke City,Marko Arnautović,2792,29,40,-11,-0.003939828080229226
2016-2017,Stoke City,Bruno Martins Indi,3147,35,46,-11,-0.0034953924372418178
2016-2017,Stoke City,Ryan Shawcross,3150,34,48,-14,-0.0044444444444444444
2016-2017,Stoke City,Mame Biram Diouf,1358,15,23,-8,-0.005891016200294551
2016-2017,Stoke City,Geoff Cameron,1620,17,23,-6,-0.003703703703703704
2016-2017,Stoke City,Xherdan Shaqiri,1709,22,20,2,0.0011702750146284377
2016-2017,Stoke City,Lee Grant,2520,31,31,0,0.0
2016-2017,Stoke City,Marc Muniesa,645,7,6,1,0.0015503875968992248
2016-2017,Stoke City,Saido Berahino,966,6,13,-7,-0.007246376811594203
2016-2017,Stoke City,Charlie Adam,1474,17,19,-2,-0.0013568521031207597
2016-2017,Stoke City,Jonathan Walters,1296,14,19,-5,-0.0038580246913580245
2016-2017,Stoke City,Peter Crouch,1323,19,20,-1,-0.0007558578987150416
2016-2017,Stoke City,Ramadan Sobhi,819,7,9,-2,-0.002442002442002442
2016-2017,Crystal Palace,Wayne Hennessey,2610,32,46,-14,-0.0053639846743295016
2016-2017,Crystal Palace,Joel Ward,3418,47,63,-16,-0.004681100058513751
2016-2017,Crystal Palace,James Tomkins,1969,29,35,-6,-0.0030472320975114273
2016-2017,Crystal Palace,Yohan Cabaye,2130,30,41,-11,-0.005164319248826291
2016-2017,Crystal Palace,Andros Townsend,2527,34,38,-4,-0.0015829046299960427
2016-2017,Crystal Palace,Wilfried Zaha,3025,45,56,-11,-0.0036363636363636364
2016-2017,Crystal Palace,Christian Benteke,3138,47,58,-11,-0.003505417463352454
2016-2017,Crystal Palace,Luka Milivojević,1227,17,16,1,0.0008149959250203749
2016-2017,Crystal Palace,Jeffrey Schlupp,1124,14,16,-2,-0.0017793594306049821
2016-2017,Crystal Palace,Martin Kelly,2126,29,44,-15,-0.0070555032925682035
2016-2017,Crystal Palace,Jason Puncheon,3096,42,53,-11,-0.0035529715762273903
2016-2017,Crystal Palace,Patrick van Aanholt,2587,27,56,-29,-0.011209895632006184
2016-2017,Crystal Palace,James McArthur,1999,27,39,-12,-0.006003001500750375
2016-2017,Crystal Palace,Damien Delaney,1991,23,40,-17,-0.008538422903063787
2016-2017,West Ham United,Adrián,1440,13,25,-12,-0.008333333333333333
2016-2017,West Ham United,Winston Reid,2590,34,48,-14,-0.005405405405405406
2016-2017,West Ham United,Aaron Cresswell,2133,31,35,-4,-0.001875293014533521
2016-2017,West Ham United,Håvard Nordtveit,938,8,17,-9,-0.009594882729211088
2016-2017,West Ham United,Manuel Lanzini,2715,33,53,-20,-0.007366482504604052
2016-2017,West Ham United,James Collins,1639,19,28,-9,-0.005491153142159854
2016-2017,West Ham United,André Ayew,1438,19,25,-6,-0.004172461752433936
2016-2017,West Ham United,Sam Byram,1239,22,27,-5,-0.004035512510088781
2016-2017,West Ham United,José Fonte,3025,32,47,-15,-0.0049586776859504135
2016-2017,West Ham United,Jonathan Calleri,528,9,4,5,0.00946969696969697
2016-2017,West Ham United,Edimilson Fernandes,948,11,15,-4,-0.004219409282700422
2016-2017,West Ham United,Darren Randolph,1980,33,39,-6,-0.0030303030303030303
2016-2017,West Ham United,Sofiane Feghouli,1105,18,23,-5,-0.004524886877828055
2016-2017,West Ham United,Robert Snodgrass,2534,34,54,-20,-0.007892659826361484
2016-2017,West Ham United,Angelo Ogbonna,1756,23,31,-8,-0.004555808656036446
2016-2017,Tottenham Hotspur,Hugo Lloris,3005,78,23,55,0.018302828618968387
2016-2017,Tottenham Hotspur,Toby Alderweireld,2604,65,17,48,0.018433179723502304
2016-2017,Tottenham Hotspur,Jan Vertonghen,2897,75,20,55,0.018985157059026578
2016-2017,Tottenham Hotspur,Son Heung-min,2064,57,17,40,0.01937984496124031
2016-2017,Tottenham Hotspur,Harry Kane,2536,64,19,45,0.01774447949526814
2016-2017,Tottenham Hotspur,Victor Wanyama,3015,68,24,44,0.014593698175787729
2016-2017,Tottenham Hotspur,Eric Dier,3044,78,23,55,0.01806833114323259
2016-2017,Tottenham Hotspur,Kieran Trippier,543,21,3,18,0.03314917127071823
2016-2017,Tottenham Hotspur,Dele Alli,3045,77,23,54,0.017733990147783252
2016-2017,Tottenham Hotspur,Christian Eriksen,3167,74,23,51,0.016103568045468898
2016-2017,Tottenham Hotspur,Ben Davies,1735,47,13,34,0.019596541786743516
2016-2017,Tottenham Hotspur,Kyle Walker,2695,55,20,35,0.012987012987012988
2016-2017,Tottenham Hotspur,Vincent Janssen,798,20,7,13,0.016290726817042606
2016-2017,Tottenham Hotspur,Moussa Sissoko,879,22,4,18,0.020477815699658702
2016-2017,Tottenham Hotspur,Mousa Dembélé,2065,48,16,32,0.01549636803874092
2016-2017,Manchester City,Willy Caballero,1451,38,13,25,0.01722949689869056
2016-2017,Manchester City,Vincent Kompany,900,23,7,16,0.017777777777777778
2016-2017,Manchester City,Sergio Agüero,2578,50,31,19,0.007370054305663305
2016-2017,Manchester City,Aleksandar Kolarov,2713,58,27,31,0.01142646516771102
2016-2017,Manchester City,Kevin De Bruyne,2953,66,35,31,0.010497798848628514
2016-2017,Manchester City,Leroy Sané,1873,41,16,25,0.013347570742124934
2016-2017,Manchester City,David Silva,2940,67,32,35,0.011904761904761904
2016-2017,Manchester City,Fernandinho,2993,67,27,40,0.013364517206815904
2016-2017,Manchester City,Nicolás Otamendi,2682,65,27,38,0.014168530947054437
2016-2017,Manchester City,Gabriel Jesus,639,22,5,17,0.026604068857589983
2016-2017,Manchester City,Yaya Touré,1947,45,17,28,0.014381099126861838
2016-2017,Manchester City,Pablo Zabaleta,1041,19,17,2,0.0019212295869356388
2016-2017,Manchester City,Fernando,624,16,8,8,0.01282051282051282
2016-2017,Manchester City,Raheem Sterling,2679,61,27,34,0.01269130272489735
2016-2017,Manchester City,Jesús Navas,1045,17,16,1,0.0009569377990430622
2016-2017,Manchester City,Gaël Clichy,2125,47,24,23,0.010823529411764706
2016-2017,Manchester City,John Stones,2186,42,29,13,0.005946935041171089
2016-2017,Swansea City,Jordan Ayew,855,11,6,5,0.005847953216374269
2016-2017,Swansea City,Alfie Mawson,2430,31,41,-10,-0.00411522633744856
2016-2017,Swansea City,Leon Britton,1177,13,24,-11,-0.009345794392523364
2016-2017,Swansea City,Leroy Fer,2403,33,45,-12,-0.004993757802746567
2016-2017,Swansea City,Fernando Llorente,2451,35,46,-11,-0.00448796409628723
2016-2017,Swansea City,Martin Olsson,1253,20,18,2,0.0015961691939345571
2016-2017,Swansea City,Gylfi Sigurðsson,3327,44,65,-21,-0.0063119927862939585
2016-2017,Swansea City,Kyle Naughton,2718,35,45,-10,-0.003679175864606328
2016-2017,Swansea City,Federico Fernández,2430,36,37,-1,-0.00041152263374485596
2016-2017,Swansea City,Tom Carroll,1390,21,17,4,0.0028776978417266188
2016-2017,Swansea City,Jordi Amat,1407,19,35,-16,-0.011371712864250177
2016-2017,Swansea City,Ki Sung-yueng,1275,11,23,-12,-0.009411764705882352
2016-2017,Swansea City,Jack Cork,2230,32,47,-15,-0.006726457399103139
2016-2017,Swansea City,Stephen Kingsley,1036,9,17,-8,-0.007722007722007722
2016-2017,Chelsea,Thibaut Courtois,3330,84,27,57,0.017117117117117116
2016-2017,Chelsea,Marcos Alonso,2784,74,18,56,0.020114942528735632
2016-2017,Chelsea,Cesc Fàbregas,1295,37,12,25,0.019305019305019305
2016-2017,Chelsea,N'Golo Kanté,3229,81,32,49,0.015174976772994736
2016-2017,Chelsea,Eden Hazard,3085,76,29,47,0.015235008103727715
2016-2017,Chelsea,Victor Moses,2577,71,14,57,0.02211874272409779
2016-2017,Chelsea,Diego Costa,3167,73,29,44,0.013893274392169246
2016-2017,Chelsea,Willian,1513,35,17,18,0.011896893588896233
2016-2017,Chelsea,John Terry,478,14,8,6,0.012552301255230125
2016-2017,Chelsea,César Azpilicueta,3510,88,32,56,0.015954415954415956
2016-2017,Chelsea,David Luiz,3046,74,25,49,0.01608667104399212
2016-2017,Chelsea,Pedro,2186,51,14,37,0.016925892040256175
2016-2017,Chelsea,Nemanja Matić,2787,62,24,38,0.013634732687477575
2016-2017,Chelsea,Gary Cahill,3386,83,28,55,0.016243354991139988
2016-2017,Arsenal,Petr Čech,3188,72,37,35,0.010978670012547051
2016-2017,Arsenal,Gabriel Paulista,1516,32,18,14,0.009234828496042216
2016-2017,Arsenal,Laurent Koscielny,2989,63,37,26,0.008698561391769822
2016-2017,Arsenal,Alexis Sánchez,3313,74,42,32,0.009658919408391186
2016-2017,Arsenal,Aaron Ramsey,1231,28,20,8,0.006498781478472786
2016-2017,Arsenal,Mesut Özil,2938,66,30,36,0.012253233492171545
2016-2017,Arsenal,Rob Holding,810,21,8,13,0.016049382716049384
2016-2017,Arsenal,Nacho Monreal,3153,67,42,25,0.00792895654931811
2016-2017,Arsenal,Danny Welbeck,728,15,10,5,0.006868131868131868
2016-2017,Arsenal,Héctor Bellerín,2581,58,33,25,0.009686168151879117
2016-2017,Arsenal,Granit Xhaka,2521,54,32,22,0.00872669575565252
2016-2017,Arsenal,Olivier Giroud,1200,28,16,12,0.01
2016-2017,Arsenal,Theo Walcott,1904,33,25,8,0.004201680672268907
2016-2017,Arsenal,Alex Iwobi,1529,26,21,5,0.0032701111837802484
2016-2017,Arsenal,Francis Coquelin,1873,40,27,13,0.0069407367859049655
2016-2017,Arsenal,Mohamed Elneny,781,21,10,11,0.014084507042253521
2016-2017,Southampton,Fraser Forster,3510,40,49,-9,-0.002564102564102564
2016-2017,Southampton,Cédric Soares,2515,29,36,-7,-0.002783300198807157
2016-2017,Southampton,Maya Yoshida,2070,27,32,-5,-0.0024154589371980675
2016-2017,Southampton,Steven Davis,2733,31,38,-7,-0.002561287961946579
2016-2017,Southampton,Charlie Austin,1012,10,9,1,0.0009881422924901185
2016-2017,Southampton,Dušan Tadić,2497,28,30,-2,-0.0008009611533840609
2016-2017,Southampton,Oriol Romeu,3162,36,43,-7,-0.002213788741302973
2016-2017,Southampton,James Ward-Prowse,1840,18,25,-7,-0.0038043478260869567
2016-2017,Southampton,Ryan Bertrand,2508,28,36,-8,-0.003189792663476874
2016-2017,Southampton,Nathan Redmond,3030,36,41,-5,-0.0016501650165016502
2016-2017,Southampton,Jack Stephens,1468,17,24,-7,-0.004768392370572207
2016-2017,Southampton,Jordy Clasie,1091,15,15,0,0.0
2016-2017,Southampton,Sofiane Boufal,1121,11,22,-11,-0.009812667261373774
2016-2017,Southampton,Manolo Gabbiadini,732,7,13,-6,-0.00819672131147541
2016-2017,Southampton,Pierre Højbjerg,1310,15,16,-1,-0.0007633587786259542
2016-2017,Hull City,David Marshall,1530,12,41,-29,-0.01895424836601307
2016-2017,Hull City,Curtis Davies,2228,19,50,-31,-0.013913824057450628
2016-2017,Hull City,Tom Huddlestone,2013,19,46,-27,-0.013412816691505217
2016-2017,Hull City,Alfred N'Diaye,1277,14,29,-15,-0.011746280344557557
2016-2017,Hull City,Sam Clucas,3280,32,72,-40,-0.012195121951219513
2016-2017,Hull City,Andrea Ranocchia,1329,17,29,-12,-0.009029345372460496
2016-2017,Hull City,Omar Elabdellaoui,616,6,16,-10,-0.016233766233766232
2016-2017,Hull City,Michael Dawson,1800,14,40,-26,-0.014444444444444444
2016-2017,Hull City,Oumar Niasse,1153,15,28,-13,-0.011274934952298352
2016-2017,Hull City,Eldin Jakupović,1980,24,34,-10,-0.005050505050505051
2016-2017,Hull City,Andrew Robertson,2735,31,55,-24,-0.008775137111517367
2016-2017,Hull City,Kamil Grosicki,1146,16,25,-9,-0.007853403141361256
2016-2017,Hull City,Dieumerci Mbokani,759,7,14,-7,-0.00922266139657444
2016-2017,Hull City,Ahmed Elmohamady,2663,29,57,-28,-0.010514457378895982
2016-2017,Manchester United,Eric Bailly,2107,36,17,19,0.009017560512577124
2016-2017,Manchester United,Phil Jones,1585,25,13,12,0.007570977917981073
2016-2017,Manchester United,Paul Pogba,2789,46,24,22,0.007888131946934385
2016-2017,Manchester United,Wayne Rooney,1548,25,16,9,0.005813953488372093
2016-2017,Manchester United,Jesse Lingard,1485,23,15,8,0.0053872053872053875
2016-2017,Manchester United,Anthony Martial,1565,20,14,6,0.0038338658146964857
2016-2017,Manchester United,Michael Carrick,1600,21,14,7,0.004375
2016-2017,Manchester United,Daley Blind,2009,27,20,7,0.003484320557491289
2016-2017,Liverpool,Simon Mignolet,2520,51,30,21,0.008333333333333333
2016-2017,Liverpool,Nathaniel Clyne,3414,78,42,36,0.01054481546572935
2016-2017,Liverpool,Georginio Wijnaldum,2989,65,38,27,0.009033121445299431
2016-2017,Liverpool,Dejan Lovren,2645,54,32,22,0.00831758034026465
2016-2017,Liverpool,James Milner,3250,70,36,34,0.010461538461538461
2016-2017,Liverpool,Philippe Coutinho,2332,53,28,25,0.01072041166380789
2016-2017,Liverpool,Roberto Firmino,3159,70,40,30,0.00949667616334283
2016-2017,Liverpool,Daniel Sturridge,745,22,7,15,0.020134228187919462
2016-2017,Liverpool,Adam Lallana,2428,58,32,26,0.01070840197693575
2016-2017,Liverpool,Emre Can,2445,51,29,22,0.00899795501022495
2016-2017,Liverpool,Joël Matip,2545,57,26,31,0.01218074656188605
2016-2017,Liverpool,Loris Karius,990,28,13,15,0.015151515151515152
2016-2017,Liverpool,Ragnar Klavan,1394,33,19,14,0.010043041606886656
2016-2017,Liverpool,Lucas Leiva,1067,24,16,8,0.007497656982193065
2016-2017,Liverpool,Divock Origi,1421,27,17,10,0.007037297677691766
2016-2017,Watford,Heurelho Gomes,3429,38,62,-24,-0.00699912510936133
2016-2017,Watford,Nordin Amrabat,2186,22,49,-27,-0.012351326623970723
2016-2017,Watford,Tom Cleverley,1830,20,38,-18,-0.009836065573770493
2016-2017,Watford,Valon Behrami,2127,29,39,-10,-0.004701457451810061
2016-2017,Watford,Abdoulaye Doucouré,1351,10,30,-20,-0.014803849000740192
2016-2017,Watford,M'Baye Niang,1245,14,26,-12,-0.00963855421686747
2016-2017,Watford,Daryl Janmaat,1625,20,32,-12,-0.0073846153846153844
2016-2017,Watford,José Holebas,3000,34,60,-26,-0.008666666666666666
2016-2017,Watford,Étienne Capoue,3303,34,58,-24,-0.007266121707538601
2016-2017,Watford,Stefano Okaka,944,9,23,-14,-0.014830508474576272
2016-2017,Watford,Troy Deeney,3031,35,50,-15,-0.0049488617617947876
2016-2017,Watford,Juan Zúñiga,788,9,14,-5,-0.006345177664974619
2016-2017,Burnley,Tom Heaton,3330,38,47,-9,-0.002702702702702703
2016-2017,Burnley,Matthew Lowton,3420,40,52,-12,-0.0035087719298245615
2016-2017,Burnley,Andre Gray,2328,24,32,-8,-0.003436426116838488
2016-2017,Burnley,Sam Vokes,2197,29,34,-5,-0.002275830678197542
2016-2017,Burnley,Robbie Brady,709,9,10,-1,-0.0014104372355430183
2016-2017,Burnley,Jeff Hendrick,2959,30,46,-16,-0.005407232173031429
2016-2017,Burnley,Ashley Westwood,536,9,8,1,0.0018656716417910447
2016-2017,Burnley,Stephen Ward,3359,35,52,-17,-0.00506103006847276
2016-2017,Burnley,James Tarkowski,532,10,10,0,0.0
2016-2017,Burnley,Scott Arfield,2279,23,37,-14,-0.00614304519526108
2016-2017,Burnley,Ashley Barnes,1792,15,26,-11,-0.006138392857142857
2016-2017,Burnley,Steven Defour,1073,16,13,3,0.0027958993476234857
2016-2017,Burnley,Jóhann Berg Guðmundsson,1163,13,19,-6,-0.005159071367153913
2016-2017,Leicester City,Kasper Schmeichel,2667,34,46,-12,-0.0044994375703037125
2016-2017,Leicester City,Ben Chilwell,688,6,18,-12,-0.01744186046511628
2016-2017,Leicester City,Jamie Vardy,2870,41,55,-14,-0.004878048780487805
2016-2017,Leicester City,Andy King,1426,23,25,-2,-0.001402524544179523
2016-2017,Leicester City,Marc Albrighton,2417,35,45,-10,-0.004137360364087712
2016-2017,Leicester City,Danny Simpson,2990,43,48,-5,-0.0016722408026755853
2016-2017,Leicester City,Islam Slimani,1263,19,22,-3,-0.0023752969121140144
2016-2017,Leicester City,Wilfred Ndidi,1522,21,27,-6,-0.003942181340341655
2016-2017,Leicester City,Riyad Mahrez,2837,39,46,-7,-0.0024673951357067326
2016-2017,Leicester City,Christian Fuchs,3104,43,55,-12,-0.003865979381443299
2016-2017,Leicester City,Yohan Benalouane,921,18,14,4,0.004343105320304018
2016-2017,Leicester City,Ron-Robert Zieler,753,12,15,-3,-0.00398406374501992
2016-2017,Leicester City,Ahmed Musa,740,8,20,-12,-0.016216216216216217
2016-2017,Leicester City,Daniel Amartey,1663,20,34,-14,-0.00841852074564041
2016-2017,Leicester City,Shinji Okazaki,1565,25,26,-1,-0.0006389776357827476
2016-2017,Leicester City,Demarai Gray,999,12,19,-7,-0.007007007007007007
