Season,Team,Player Name,Accumulated Playing Time,Accumulated Goals Scored,Accumulated Goals Lost,Plus-Minus,Plus-Minus Per Min
2016-2017,Hull City,Andrew Robertson,1053,11,25,-14,-0.013295346628679962
2016-2017,Hull City,Curtis Davies,1620,14,35,-21,-0.012962962962962963
2016-2017,Hull City,David Meyler,699,6,17,-11,-0.015736766809728183
2016-2017,Hull City,Tom Huddlestone,877,8,20,-12,-0.013683010262257697
2016-2017,Hull City,Abel Hernández,753,6,9,-3,-0.00398406374501992
2016-2017,Hull City,Robert Snodgrass,1366,14,33,-19,-0.013909224011713031
2016-2017,Hull City,Sam Clucas,1580,13,34,-21,-0.013291139240506329
2016-2017,Hull City,Jake Livermore,1555,14,34,-20,-0.012861736334405145
2016-2017,Hull City,Adama Diomande,844,6,17,-11,-0.013033175355450236
2016-2017,Hull City,Ahmed Elmohamady,1530,14,33,-19,-0.01241830065359477
2016-2017,Burnley,Tom Heaton,1440,16,22,-6,-0.004166666666666667
2016-2017,Burnley,Matthew Lowton,1530,17,24,-7,-0.004575163398692811
2016-2017,Burnley,Michael Keane,1620,17,26,-9,-0.005555555555555556
2016-2017,Burnley,Ben Mee,1620,17,26,-9,-0.005555555555555556
2016-2017,Burnley,Andre Gray,784,4,10,-6,-0.007653061224489796
2016-2017,Burnley,Dean Marney,1552,17,24,-7,-0.004510309278350515
2016-2017,Burnley,Sam Vokes,1414,14,21,-7,-0.0049504950495049506
2016-2017,Burnley,George Boyd,1080,11,19,-8,-0.007407407407407408
2016-2017,Burnley,Stephen Ward,1424,12,24,-12,-0.008426966292134831
2016-2017,Burnley,Scott Arfield,1156,11,19,-8,-0.006920415224913495
2016-2017,Burnley,Jóhann Berg Guðmundsson,1003,11,15,-4,-0.003988035892323031
2016-2017,Southampton,Fraser Forster,1620,17,17,0,0.0
2016-2017,Southampton,Cédric Soares,916,9,10,-1,-0.001091703056768559
2016-2017,Southampton,Steven Davis,1298,14,13,1,0.0007704160246533128
2016-2017,Southampton,Dušan Tadić,1031,11,11,0,0.0
2016-2017,Southampton,Oriol Romeu,1452,14,14,0,0.0
2016-2017,Southampton,Virgil van Dijk,1620,17,17,0,0.0
2016-2017,Southampton,Nathan Redmond,1524,17,17,0,0.0
2016-2017,Southampton,Jordy Clasie,745,10,11,-1,-0.0013422818791946308
2016-2017,Southampton,José Fonte,1440,13,15,-2,-0.001388888888888889
2016-2017,Southampton,Charlie Austin,947,10,8,2,0.0021119324181626186
2016-2017,Southampton,Pierre Højbjerg,823,9,7,2,0.002430133657351154
2016-2017,Crystal Palace,Wayne Hennessey,720,11,15,-4,-0.005555555555555556
2016-2017,Crystal Palace,Joel Ward,1528,26,32,-6,-0.003926701570680628
2016-2017,Crystal Palace,Scott Dann,1170,22,25,-3,-0.002564102564102564
2016-2017,Crystal Palace,Andros Townsend,1111,17,20,-3,-0.0027002700270027003
2016-2017,Crystal Palace,Wilfried Zaha,1374,24,29,-5,-0.00363901018922853
2016-2017,Crystal Palace,Damien Delaney,1206,19,21,-2,-0.001658374792703151
2016-2017,Crystal Palace,Jason Puncheon,1219,21,22,-1,-0.0008203445447087777
2016-2017,Crystal Palace,Yohan Cabaye,913,13,26,-13,-0.014238773274917854
2016-2017,Crystal Palace,Yannick Bolasie,1142,13,15,-2,-0.0017513134851138354
2016-2017,Crystal Palace,Joe Ledley,894,19,16,3,0.003355704697986577
2016-2017,Crystal Palace,Martin Kelly,1030,15,25,-10,-0.009708737864077669
2016-2017,Middlesbrough,Víctor Valdés,1440,15,18,-3,-0.0020833333333333333
2016-2017,Middlesbrough,George Friend,1018,11,12,-1,-0.0009823182711198428
2016-2017,Middlesbrough,Ben Gibson,1620,17,19,-2,-0.0012345679012345679
2016-2017,Middlesbrough,Adam Clayton,1258,16,12,4,0.003179650238473768
2016-2017,Middlesbrough,Álvaro Negredo,1410,15,17,-2,-0.0014184397163120568
2016-2017,Middlesbrough,Marten de Roon,1134,10,15,-5,-0.004409171075837742
2016-2017,Middlesbrough,Antonio Barragán,1599,17,19,-2,-0.0012507817385866166
2016-2017,Middlesbrough,Stewart Downing,1109,13,14,-1,-0.0009017132551848512
2016-2017,Middlesbrough,Gastón Ramírez,1052,13,9,4,0.0038022813688212928
2016-2017,Middlesbrough,Cristhian Stuani,602,5,9,-4,-0.006644518272425249
2016-2017,Middlesbrough,Adam Forshaw,1501,15,17,-2,-0.0013324450366422385
2016-2017,Everton,Maarten Stekelenburg,1440,19,21,-2,-0.001388888888888889
2016-2017,Everton,Leighton Baines,886,14,9,5,0.0056433408577878106
2016-2017,Everton,Phil Jagielka,1253,15,17,-2,-0.0015961691939345571
2016-2017,Everton,Gerard Deulofeu,470,10,7,3,0.006382978723404255
2016-2017,Everton,Ross Barkley,1201,15,17,-2,-0.0016652789342214821
2016-2017,Everton,Kevin Mirallas,960,16,12,4,0.004166666666666667
2016-2017,Everton,Idrissa Gana Gueye,1391,20,14,6,0.004313443565780014
2016-2017,Everton,Gareth Barry,1286,18,19,-1,-0.0007776049766718507
2016-2017,Everton,Ramiro Funes Mori,540,8,11,-3,-0.005555555555555556
2016-2017,Everton,Bryan Oviedo,567,6,9,-3,-0.005291005291005291
2016-2017,Manchester City,Bacary Sagna,662,18,9,9,0.013595166163141994
2016-2017,Manchester City,Raheem Sterling,1380,33,13,20,0.014492753623188406
2016-2017,Manchester City,Nolito,753,22,6,16,0.021248339973439574
2016-2017,Manchester City,Sergio Agüero,1190,24,14,10,0.008403361344537815
2016-2017,Manchester City,Aleksandar Kolarov,1561,36,18,18,0.011531069827033953
2016-2017,Manchester City,Kevin De Bruyne,1285,30,18,12,0.00933852140077821
2016-2017,Manchester City,David Silva,1423,30,17,13,0.009135628952916374
2016-2017,Manchester City,Gaël Clichy,731,16,8,8,0.01094391244870041
2016-2017,Manchester City,John Stones,1255,27,16,11,0.008764940239043825
2016-2017,Manchester City,Fernandinho,1440,33,15,18,0.0125
2016-2017,Manchester City,Pablo Zabaleta,651,14,10,4,0.006144393241167435
2016-2017,Manchester City,Fernando,608,16,7,9,0.014802631578947368
2016-2017,Manchester City,Jesús Navas,464,7,9,-2,-0.004310344827586207
2016-2017,Manchester City,Nicolás Otamendi,1222,32,12,20,0.016366612111292964
2016-2017,Bournemouth,Artur Boruc,1440,21,27,-6,-0.004166666666666667
2016-2017,Bournemouth,Simon Francis,1620,23,30,-7,-0.004320987654320987
2016-2017,Bournemouth,Steve Cook,1620,23,30,-7,-0.004320987654320987
2016-2017,Bournemouth,Andrew Surman,900,12,16,-4,-0.0044444444444444444
2016-2017,Bournemouth,Harry Arter,1572,23,30,-7,-0.004452926208651399
2016-2017,Bournemouth,Charlie Daniels,1440,18,24,-6,-0.004166666666666667
2016-2017,Bournemouth,Callum Wilson,1182,18,21,-3,-0.0025380710659898475
2016-2017,Bournemouth,Adam Smith,1530,22,30,-8,-0.00522875816993464
2016-2017,Bournemouth,Joshua King,1243,12,24,-12,-0.009654062751407884
2016-2017,Bournemouth,Jordon Ibe,817,12,15,-3,-0.0036719706242350062
2016-2017,Bournemouth,Dan Gosling,662,8,11,-3,-0.004531722054380665
2016-2017,Bournemouth,Nathan Aké,551,10,13,-3,-0.0054446460980036296
2016-2017,Arsenal,Petr Čech,1620,41,19,22,0.013580246913580247
2016-2017,Arsenal,Alexis Sánchez,1527,40,19,21,0.0137524557956778
2016-2017,Arsenal,Theo Walcott,1347,26,15,11,0.008166295471417966
2016-2017,Arsenal,Alex Iwobi,739,14,10,4,0.005412719891745603
2016-2017,Arsenal,Nacho Monreal,1424,33,17,16,0.011235955056179775
2016-2017,Arsenal,Calum Chambers,1170,16,16,0,0.0
2016-2017,Arsenal,Héctor Bellerín,1325,32,16,16,0.012075471698113207
2016-2017,Arsenal,Francis Coquelin,1167,29,15,14,0.011996572407883462
2016-2017,Arsenal,Mohamed Elneny,548,16,9,7,0.012773722627737226
2016-2017,Arsenal,Jack Wilshere,1112,17,20,-3,-0.002697841726618705
2016-2017,Arsenal,Alex Oxlade-Chamberlain,769,25,9,16,0.02080624187256177
2016-2017,Arsenal,Santi Cazorla,619,16,4,12,0.01938610662358643
2016-2017,Arsenal,Granit Xhaka,968,23,12,11,0.011363636363636364
2016-2017,Chelsea,Thibaut Courtois,1620,39,10,29,0.017901234567901235
2016-2017,Chelsea,Branislav Ivanović,562,10,9,1,0.0017793594306049821
2016-2017,Chelsea,N'Golo Kanté,1620,39,10,29,0.017901234567901235
2016-2017,Chelsea,Eden Hazard,1422,36,10,26,0.01828410689170183
2016-2017,Chelsea,Diego Costa,1578,37,10,27,0.017110266159695818
2016-2017,Chelsea,Nemanja Matić,1422,32,10,22,0.015471167369901548
2016-2017,Chelsea,Willian,746,13,8,5,0.006702412868632708
2016-2017,Chelsea,Gary Cahill,1614,39,10,29,0.017967781908302356
2016-2017,Chelsea,César Azpilicueta,1620,39,10,29,0.017901234567901235
2016-2017,Chelsea,Pedro,802,21,2,19,0.02369077306733167
2016-2017,Chelsea,Victor Moses,1073,32,1,31,0.028890959925442685
2016-2017,Manchester United,David de Gea,1710,24,21,3,0.0017543859649122807
2016-2017,Manchester United,Eric Bailly,876,14,12,2,0.00228310502283105
2016-2017,Manchester United,Paul Pogba,1620,21,20,1,0.0006172839506172839
2016-2017,Manchester United,Juan Mata,939,16,11,5,0.005324813631522897
2016-2017,Manchester United,Zlatan Ibrahimović,1620,23,20,3,0.001851851851851852
2016-2017,Manchester United,Wayne Rooney,823,16,10,6,0.007290400972053463
2016-2017,Manchester United,Anthony Martial,556,8,5,3,0.00539568345323741
2016-2017,Manchester United,Daley Blind,1106,15,15,0,0.0
2016-2017,Manchester United,Luke Shaw,616,8,5,3,0.00487012987012987
2016-2017,Manchester United,Antonio Valencia,1322,19,17,2,0.0015128593040847202
2016-2017,Manchester United,Marouane Fellaini,756,11,11,0,0.0
2016-2017,Manchester United,Chris Smalling,540,6,13,-7,-0.012962962962962963
2016-2017,Manchester United,Marcus Rashford,933,9,15,-6,-0.006430868167202572
2016-2017,Manchester United,Ander Herrera,1298,16,15,1,0.0007704160246533128
2016-2017,Stoke City,Phil Bardsley,662,9,7,2,0.0030211480362537764
2016-2017,Stoke City,Erik Pieters,1440,16,18,-2,-0.001388888888888889
2016-2017,Stoke City,Joe Allen,1282,14,20,-6,-0.0046801872074883
2016-2017,Stoke City,Glenn Whelan,1128,13,17,-4,-0.0035460992907801418
2016-2017,Stoke City,Marko Arnautović,1305,13,19,-6,-0.004597701149425287
2016-2017,Stoke City,Ryan Shawcross,1260,14,19,-5,-0.003968253968253968
2016-2017,Stoke City,Mame Biram Diouf,652,8,11,-3,-0.004601226993865031
2016-2017,Stoke City,Giannelli Imbula,671,7,12,-5,-0.007451564828614009
2016-2017,Stoke City,Charlie Adam,660,6,5,1,0.0015151515151515152
2016-2017,Stoke City,Jonathan Walters,749,7,12,-5,-0.006675567423230975
2016-2017,Stoke City,Geoff Cameron,630,7,10,-3,-0.004761904761904762
2016-2017,Swansea City,Łukasz Fabiański,1530,20,35,-15,-0.00980392156862745
2016-2017,Swansea City,Jordi Amat,1260,18,30,-12,-0.009523809523809525
2016-2017,Swansea City,Leroy Fer,1080,15,23,-8,-0.007407407407407408
2016-2017,Swansea City,Fernando Llorente,1012,13,26,-13,-0.012845849802371542
2016-2017,Swansea City,Wayne Routledge,1062,13,22,-9,-0.00847457627118644
2016-2017,Swansea City,Modou Barrow,1096,14,20,-6,-0.005474452554744526
2016-2017,Swansea City,Gylfi Sigurðsson,1437,19,35,-16,-0.011134307585247043
2016-2017,Swansea City,Jack Cork,960,15,23,-8,-0.008333333333333333
2016-2017,Swansea City,Kyle Naughton,1117,13,25,-12,-0.010743061772605193
2016-2017,Swansea City,Federico Fernández,720,12,14,-2,-0.002777777777777778
2016-2017,Swansea City,Stephen Kingsley,586,5,9,-4,-0.006825938566552901
2016-2017,Swansea City,Ki Sung-yueng,539,5,12,-7,-0.012987012987012988
2016-2017,Swansea City,Mike van der Hoorn,540,4,15,-11,-0.020370370370370372
2016-2017,Swansea City,Àngel Rangel,633,7,16,-9,-0.014218009478672985
2016-2017,Swansea City,Jay Fulton,511,10,12,-2,-0.003913894324853229
2016-2017,West Bromwich Albion,Ben Foster,1710,24,27,-3,-0.0017543859649122807
2016-2017,West Bromwich Albion,Jonas Olsson,642,7,13,-6,-0.009345794392523364
2016-2017,West Bromwich Albion,Claudio Yacob,1422,21,19,2,0.0014064697609001407
2016-2017,West Bromwich Albion,Jonny Evans,1350,19,20,-1,-0.0007407407407407407
2016-2017,West Bromwich Albion,Salomón Rondón,1626,23,27,-4,-0.0024600246002460025
2016-2017,West Bromwich Albion,Matt Phillips,1354,20,18,2,0.0014771048744460858
2016-2017,West Bromwich Albion,Gareth McAuley,1710,24,27,-3,-0.0017543859649122807
2016-2017,West Bromwich Albion,Darren Fletcher,1588,24,21,3,0.001889168765743073
2016-2017,West Bromwich Albion,Craig Dawson,1604,21,26,-5,-0.003117206982543641
2016-2017,West Bromwich Albion,James Morrison,681,15,8,7,0.010279001468428781
2016-2017,West Bromwich Albion,James McClean,821,7,18,-11,-0.013398294762484775
2016-2017,Tottenham Hotspur,Kyle Walker,1367,24,9,15,0.010972933430870519
2016-2017,Tottenham Hotspur,Danny Rose,990,17,6,11,0.011111111111111112
2016-2017,Tottenham Hotspur,Toby Alderweireld,870,14,4,10,0.011494252873563218
2016-2017,Tottenham Hotspur,Jan Vertonghen,1440,26,10,16,0.011111111111111112
2016-2017,Tottenham Hotspur,Vincent Janssen,582,8,6,2,0.003436426116838488
2016-2017,Tottenham Hotspur,Harry Kane,927,20,7,13,0.014023732470334413
2016-2017,Tottenham Hotspur,Érik Lamela,593,7,2,5,0.008431703204047217
2016-2017,Tottenham Hotspur,Victor Wanyama,1402,23,10,13,0.009272467902995721
2016-2017,Tottenham Hotspur,Eric Dier,1081,22,8,14,0.012950971322849213
2016-2017,Tottenham Hotspur,Christian Eriksen,1309,24,10,14,0.0106951871657754
2016-2017,Tottenham Hotspur,Ryan Mason,860,6,21,-15,-0.01744186046511628
2016-2017,Tottenham Hotspur,Dele Alli,1140,22,9,13,0.011403508771929825
2016-2017,Watford,Heurelho Gomes,1563,19,24,-5,-0.003198976327575176
2016-2017,Watford,Miguel Britos,1345,16,20,-4,-0.002973977695167286
2016-2017,Watford,Sebastian Prödl,1375,15,19,-4,-0.002909090909090909
2016-2017,Watford,Nordin Amrabat,1328,15,26,-11,-0.008283132530120483
2016-2017,Watford,Troy Deeney,1536,20,27,-7,-0.004557291666666667
2016-2017,Watford,Valon Behrami,1385,18,22,-4,-0.002888086642599278
2016-2017,Watford,Adlène Guedioura,471,5,12,-7,-0.014861995753715499
2016-2017,Watford,Odion Ighalo,1155,12,22,-10,-0.008658008658008658
2016-2017,Watford,José Holebas,1496,18,27,-9,-0.006016042780748663
2016-2017,Watford,Étienne Capoue,1583,18,27,-9,-0.005685407454200884
2016-2017,Watford,Allan Nyom,1282,18,22,-4,-0.0031201248049922
2016-2017,Watford,Juan Zúñiga,605,8,11,-3,-0.0049586776859504135
2016-2017,Leicester City,Kasper Schmeichel,777,10,13,-3,-0.003861003861003861
2016-2017,Leicester City,Danny Drinkwater,1069,13,20,-7,-0.006548175865294668
2016-2017,Leicester City,Wes Morgan,1530,22,28,-6,-0.00392156862745098
2016-2017,Leicester City,Robert Huth,1429,21,26,-5,-0.0034989503149055285
2016-2017,Leicester City,Jamie Vardy,1314,18,26,-8,-0.0060882800608828
2016-2017,Leicester City,Marc Albrighton,1014,13,18,-5,-0.004930966469428008
2016-2017,Leicester City,Danny Simpson,1287,21,22,-1,-0.000777000777000777
2016-2017,Leicester City,Shinji Okazaki,675,11,12,-1,-0.0014814814814814814
2016-2017,Leicester City,Riyad Mahrez,1347,18,24,-6,-0.004454342984409799
2016-2017,Leicester City,Christian Fuchs,1508,22,28,-6,-0.003978779840848806
2016-2017,Leicester City,Ron-Robert Zieler,753,12,15,-3,-0.00398406374501992
2016-2017,Leicester City,Ahmed Musa,499,8,11,-3,-0.006012024048096192
2016-2017,Leicester City,Andy King,893,16,15,1,0.0011198208286674132
2016-2017,Leicester City,Daniel Amartey,1102,16,22,-6,-0.0054446460980036296
2016-2017,Sunderland,Patrick van Aanholt,1423,15,28,-13,-0.009135628952916374
2016-2017,Sunderland,Papy Djilobodji,1176,13,24,-11,-0.00935374149659864
2016-2017,Sunderland,Jack Rodwell,729,6,18,-12,-0.01646090534979424
2016-2017,Sunderland,Duncan Watmore,1113,13,24,-11,-0.009883198562443846
2016-2017,Sunderland,John O'Shea,661,2,11,-9,-0.01361573373676248
2016-2017,Sunderland,Jermain Defoe,1613,15,31,-16,-0.009919404835709857
2016-2017,Sunderland,Adnan Januzaj,728,6,18,-12,-0.016483516483516484
2016-2017,Sunderland,Jordan Pickford,1440,13,28,-15,-0.010416666666666666
2016-2017,Sunderland,Wahbi Khazri,515,4,14,-10,-0.019417475728155338
2016-2017,Sunderland,Steven Pienaar,753,5,9,-4,-0.005312084993359893
2016-2017,West Ham United,Adrián,990,10,20,-10,-0.010101010101010102
2016-2017,West Ham United,Winston Reid,1248,15,24,-9,-0.007211538461538462
2016-2017,West Ham United,Cheikhou Kouyaté,1350,15,24,-9,-0.006666666666666667
2016-2017,West Ham United,Mark Noble,1332,13,23,-10,-0.0075075075075075074
2016-2017,West Ham United,James Collins,720,9,16,-7,-0.009722222222222222
2016-2017,West Ham United,Arthur Masuaku,527,8,18,-10,-0.018975332068311195
2016-2017,West Ham United,Michail Antonio,1375,15,25,-10,-0.007272727272727273
2016-2017,West Ham United,Darren Randolph,540,8,11,-3,-0.005555555555555556
2016-2017,West Ham United,Pedro Obiang,916,10,14,-4,-0.004366812227074236
2016-2017,West Ham United,Angelo Ogbonna,1260,14,25,-11,-0.00873015873015873
2016-2017,Liverpool,Simon Mignolet,540,14,8,6,0.011111111111111112
2016-2017,Liverpool,Nathaniel Clyne,1530,42,21,21,0.013725490196078431
2016-2017,Liverpool,Georginio Wijnaldum,1119,28,19,9,0.00804289544235925
2016-2017,Liverpool,James Milner,1333,34,16,18,0.01350337584396099
2016-2017,Liverpool,Roberto Firmino,1427,39,20,19,0.013314646110721794
2016-2017,Liverpool,Jordan Henderson,1514,42,21,21,0.013870541611624834
2016-2017,Liverpool,Sadio Mané,1390,41,15,26,0.01870503597122302
2016-2017,Liverpool,Adam Lallana,1044,33,17,16,0.01532567049808429
2016-2017,Liverpool,Joël Matip,1170,32,12,20,0.017094017094017096
2016-2017,Liverpool,Loris Karius,990,28,13,15,0.015151515151515152
2016-2017,Liverpool,Philippe Coutinho,1055,28,12,16,0.015165876777251185
